111230132
321032120
001232102
111230032
321021102
001213213
111232013
321032203
001232120
111230031
321020213
001210213