w1
111230132
121032120
101232102
1112300321
121021102
101213213
111232013
121032203
101232120
111230031
121020213
101210213