w2
111230132
121032120
10123a102
111230032
121021102
101213213
111232013
121032203
101232120
111230031
121020213
101210213